11111111111111111111111
10100010000000000000001
1P10101C100000001110001
10101010100000001010001
101C1010100111111010001
101010101001E0000011101
10101C10100111111000001
10001000100000000000001
11111111111111111111111